~~~~~~~~~~
~........~
~~...###.~
~~...#...~
~~...#...~
~...##...~
~........~
~........~
~~~...~~~~
~~~~~~~~~~

