~~~~~~~~~~~~
~~.....~~~~~
~..#.....~~~
~..#.......~
~..#.......~
~..#######.~
~..#..#....~
~..#..#....~
~..#..##...~
~~~#.......~
~~....~....~
~....~~~.~.~
~~~~~~~~~~~~
