~~~~~~~~~~~~
~..........~
~..#.......~
~..#.......~
~..#.......~
~..#######.~
~..........~
~..........~
~..........~
~~~~~~~~~~~~
